type octile
height 26
width 26
map
@@@@@@@@@@@@@@@@@@@@@@@@@@
@@@@...@@@.........@@@...@
@@@@...@@@.........@@@...@
@@@@...@@@.........@@@...@
@.........@@@...@@@......@
@.........@@@...@@@......@
@.........@@@...@@@......@
@...@@@..................@
@...@@@..................@
@...@@@..................@
@...@@@...@@@...@@@......@
@...@@@...@@@...@@@......@
@...@@@...@@@...@@@......@
@......@@@......@@@...@@@@
@......@@@......@@@...@@@@
@......@@@......@@@...@@@@
@...@@@@@@...@@@.........@
@...@@@@@@...@@@.........@
@...@@@@@@...@@@.........@
@.........@@@...@@@@@@...@
@.........@@@...@@@@@@...@
@.........@@@...@@@@@@...@
@........................@
@........................@
@........................@
@@@@@@@@@@@@@@@@@@@@@@@@@@
