25 25
.........................
...........@@@@@.........
...........@@@@@@........
......@...@@@@@@@........
......@.@.@@@@@@.........
......@@@@@@.@.@.........
.....@@@@@...............
.....@@@@@...............
.....@@@@................
......@@.................
.........................
.........................
.........................
.........@...............
.........@@@.............
........@@@..............
.........@@..............
.........................
.........................
.........................
.........................
.........................
.........................
.........................
.........................
