30 30
@@@@@@@@@@@@@@@@@@@@@@@@@@@@@@
@.....@..@.@..@@@.@.@..@@.@..@
@....@...@@.@@@.....@@.@@.@@.@
@.@@@......@..@@@...@..@.@..@@
@.@@@@@.@.@...@..@.@....@@...@
@@..@@..@.............@....@@@
@@@.@....@@....@...@......@@@@
@@@..@@@...@.@....@.@.@.@@@..@
@...@.@....@.@.....@.....@@.@@
@.@.@....@@.@........@...@.@.@
@....@@.@...@........@..@@@@@@
@@.@@.@.@.@.@..@@@..@.@@..@@@@
@@..@.@..@.@.@.@.@@.@@.@..@.@@
@..@@@.@.@..@..@...@@@@......@
@@@...@.@@..@..@@@@..@.@.@...@
@@..@..@...@...@.@....@@.@@@.@
@..@@@...@...@@..@@@@@@.@@.@@@
@..@@@..@.@@@.@..@@...@@@..@@@
@@@@.@.@.@@@@.@.......@....@.@
@@@..@.@.....@..@.....@.@@@.@@
@@@@@..@.@....@..@....@.@@@.@@
@....@.@.@..@@.@.@....@@..@.@@
@.@..@.....@@@...@@...@@@.@..@
@@@@@@@..@@@.@@.@...@..@@@@..@
@.@@.....@......@@@@@@@.@.@@.@
@@.@.@..@@..@.@@@....@@.@@..@@
@@.@@@@..@....@....@@@....@..@
@@.@@@@@@@.....@@........@@..@
@...@@....@.@.@..@..@.@..@@..@
@@@@@@@@@@@@@@@@@@@@@@@@@@@@@@
