10 10
@@@@@@@@@@
@....@.@.@
@...@.@..@
@...@.@..@
@...@..@.@
@..@...@.@
@.......@@
@@.......@
@..@.....@
@@@@@@@@@@
