10 10
@@@@@@@@@@
@........@
@.@..@...@
@........@
@.@.@.@@.@
@........@
@..@...@.@
@...@.@.@@
@.@@.....@
@@@@@@@@@@
