50 50
@@@@@@@@@@@@@@@@@@@@@@@@@@@@@@@@@@@@@@@@@@@@@@@@@@
@...@@.@...@..............@@@.@.@....@.....@@....@
@.@.....@.@..@.@@.@.@.@.@..@.....@@.@.@.@@....@@@@
@..@@.@.....@@...@.@.@.@.@@..@.@......@.@..@@....@
@@...@..@.@...@@@...........@.@.@@@@@.@..@@.@.@.@@
@@.@.@@..@..@.....@.@@.@@.@.........@...@.@..@@.@@
@..@@...@@.@.@@.@@.@.@...@..@.@.@@.@@.@.....@.@@.@
@@..@.@.@.....@.......@@@.@@.@..@.@..@..@@@@@....@
@..@@..@@.@@@..@@@.@@.........@@..@.@.@.......@.@@
@@.@..@......@.@.@.@.@.@.@.@@@..@...@..@.@.@.@...@
@...@..@@.@.@.@@.@...@..@.@....@@@.@.@..@...@.@@@@
@@.@.@@..@........@@.@@.....@@..@..@...@..@.@.@..@
@.......@@@.@.@.@..@@..@@.@..@.@..@..@@.@@@.....@@
@@.@.@@..@.@..@..@....@@.@.@@.@.@.@.@.@....@@.@..@
@...@.@@...@.@@@.@.@.@..................@.@.@..@.@
@.@.....@.@...@..@.@...@@.@@@.@.@.@.@@.@@.@...@.@@
@.@.@@.@..@@@..@.@..@.@@.@...@...@@..@.@..@.@....@
@.@.@...@....@..@@.@@......@..@@...@@...@@.@.@@.@@
@.@..@.@..@.@@.@.....@.@@.@@@...@@.@.@@@.@...@.@@@
@@..@...@..@....@.@.@....@.@..@...@.......@.@...@@
@.@..@.@@@..@@.@...@@@.@@...@..@@...@.@.@.....@..@
@...@...@..@...@@.@@@.....@@..@@.@.@...@..@.@.@@@@
@.@..@.@.@..@.@....@.@.@.@..@.....@.@@@..@@@.....@
@.@.@....@@.@.@@.@...@@.@@.@.@@.@......@.@@@@.@.@@
@@@..@.@...@...@@..@...........@..@.@@@@..@....@@@
@...@...@.@.@.@.@@.@@.@.@.@@@.@@@..@....@..@@.@@@@
@@.@@.@@.....@@.....@..@.....@.@.@.@@.@..@...@@@@@
@..@.@.@@.@.@..@.@.@@.@..@.@.@...@.....@..@.@@@@@@
@@.......@@..@...@...@..@..@@.@@...@.@.@.@@@@@@@@@
@.@.@@.@...@.@@.@..@@..@.@.....@.@@...@..@@.@@@@@@
@.....@.@@..@....@...@.@...@@@@.@..@.@.@.....@@@@@
@@@.@.....@..@@@@..@@.@.@@........@....@@@@@@.@@@@
@....@.@.@..@....@.......@.@.@.@.@@@.@...........@
@.@.@...@@@@.@@@...@.@.@.@..@..@@.@@..@.@@.@.@@@@@
@.@.@.@.@@.@.....@@...@@@.@..@....@..@@.@.@.@@@@@@
@..@..@.....@@.@..@.@..@..@.@@@@.@..@........@@@@@
@@.@.@..@@.@...@.@...@...@.@.@@...@.@.@.@.@.@@@@@@
@..@..@..@.@.@..@..@.@.@...@...@@.@.@.@..@@@@@@@@@
@@.@.@.@@...@@@..@.@..@..@...@@..@..@..@.@@.@@@@@@
@.@....@@@.@.@@.@.@.@@.@.@.@....@@@.@@.@....@@@@@@
@.@.@@..@..@............@@.@@.@.@@@.@@@..@@..@@@@@
@.....@..@..@@.@@.@@.@@.@.@..@@.@@@@@@@@..@@@@@@@@
@@.@.@@.@..@...@@...@.@@....@.@@.@@@@@@@@.@@@@@@@@
@@@....@@@.@@.@...@......@@.......@@@@@@@.@@@@@@@@
@@@@.@..@...@..@@.@.@@@.@@@@@@.@.@@@@@@@@.@@@@@@@@
@@@@@..@@@.@..@.@@..@.@@.@@...@@@@@@@@@@@@@@@@@@@@
@@@.@@..@...@....@@.........@.@@@@@@@@@@@@@@@@@@@@
@@@.@..@@@.@@@.@@.@@.@@@.@@..@@@@@@@@@@@@@@@@@@@@@
@.....@@@@...@@.........@@@.@@@@@@@@@@@@@@@@@@@@@@
@@@@@@@@@@@@@@@@@@@@@@@@@@@@@@@@@@@@@@@@@@@@@@@@@@
