40 40
@@@@@@@@@@@@@@@@@@@@@@@@@@@@@@@@@@@@@@@@
@..@@@.@@.@..@....@..@.@.....@..@.@...@@
@..@@.@..@.@..@.@@@.@.@.@@@@@...@......@
@@..@@....@...@.@@..@@@@.@@.@..@.@.@@.@@
@..@@...@@.@@....@@.@..@@...@..@..@.@@.@
@..@...@@..@@.@..@.@...@..@...@@@.@....@
@......@...@.@@@@@........@.@.....@....@
@@........@@...@@@@..@@...@.@..@@@...@.@
@@.@@..@@.@@..@...@@.@...@..@@..@@.@@@@@
@@@@.@@....@...@@@@@.@@.@@.....@@@.....@
@@..@.@.@@@@.....@@@@.@@..@..@.@..@....@
@.@@@..@......@@.....@.@.@@@@.@@...@.@@@
@@@@..@..@.@.@@..@@..@@..@....@.@.@..@@@
@@.@@@@@@@.....@..@.@.@.@@@@..@.@......@
@@@.@@.@.@@.@@.@@......@@.@@@@...@@@.@@@
@..@.@.@@@..@@.@.@.@.@@..@.@...@@.@@@@@@
@@@@..@@..@@.@@@..@..@@@..@.@@@..@.@@@.@
@@@.@.@@@...@@@@.@...@@...@@..@..@....@@
@.@@@@....@@@@@@@..@.@@@.@@.@.....@...@@
@.@@@@@@@.@....@@.....@@@.@.@@.@@.@.@..@
@@.@....@.@@.@@@@.....@.@......@@.@@...@
@..@.....@@.@@@.@.....@@..@...@@.....@.@
@@....@.@......@@.@..@@@.@@..@....@..@.@
@..@.......@@..@@......@.@@.....@.@.@..@
@...@@@@.@.@@@@.@@@....@@@@.@@.@...@@.@@
@@.@@.@@...@@...@@....@@@...@.@...@@@.@@
@@.@.@.@..@@...@@..@..@@....@@@..@.@...@
@@..@@....@.@..@.@.@@@.@@.@@@.@..@..@@@@
@....@@@@..@.....@.@...@.@...@....@....@
@@.@.@...@...@..@...@.@....@@..@@@....@@
@@....@.@.@@........@@...@@.@.@@@..@.@@@
@.@...@....@@@.....@@@.@@...@.@........@
@@.@....@@..@@@@...@@@.@@.@.@...@.@..@.@
@@.@@@@@@.@.@@.@.@@.@.@.@@..@...@@@....@
@@..@.@....@.@@@..@@@.@..@@.@@@..@@@@..@
@..@.....@...@@..@@.@@@@@...@@@@@.@.@..@
@@..@..@@@@.@....@...@@@.@.@@..@@@.@@@@@
@@..@..@...@@..@.@.@.@.@@.@@.....@.....@
@..@....@@@..@.@...@.@..@.....@...@@..@@
@@@@@@@@@@@@@@@@@@@@@@@@@@@@@@@@@@@@@@@@
