25 25
@@@@@@@@@@@@@@@@@@@@@@@@@
@......@@..@@...@.@.....@
@.@@..@@.@..@....@....@.@
@..@@...@@....@...@@.@@.@
@.@.@.......@..@@.@....@@
@@@@@@@..@....@@.@@@@.@.@
@.@@.....@..@@...@@..@..@
@..@@..@@.@@.@@..@.....@@
@@@.@@@@.@@@..@.....@@..@
@.@....@.@.@@.@@...@@@.@@
@@@...@@@@.@@@.@..@...@@@
@..@@@@.....@..@.@@..@..@
@....@@@..@..@@..@@.....@
@.@..@..@.@.@..@@...@.@.@
@....@..@@@@.....@@.@..@@
@......@.@@@........@.@.@
@....@..@@..@..@...@...@@
@...@.@@...@@.@@@..@.@.@@
@.....@@@...@........@..@
@@.@@..@@...@@....@..@..@
@....@@@.@@.@@.....@@.@.@
@.@..@@@.@.@...@...@@@..@
@@..@@@.@@@.@@@..@@..@..@
@@...@@..@@..@@@....@.@@@
@@@@@@@@@@@@@@@@@@@@@@@@@
