25 25
@@@@@@@@@@@@@@@@@@@@@@@@@
@..@@.....@@....@...@.@.@
@.@....@...........@.@.@@
@@...@..@@.....@....@@.@@
@.@@.@.@.@......@@.@...@@
@@@..@.@...@...@.@....@.@
@.......@@@@@.@......@@@@
@......@.@......@@..@@.@@
@.....@@...@...@@.@@.@@@@
@.....@.........@@.@@@@.@
@.@@.@@..@.@@@.@@.@@.@..@
@..@.....@@...@..@@@....@
@@@..@@@@....@......@...@
@@@.@@...@.@.@...@@.....@
@..@@@....@.@@.@.@@.@@@.@
@@..@..@@@@@.@...@@.@.@.@
@@@@.@.@@....@@...@@...@@
@@....@.@.@@.@@....@.@..@
@@@@@.@@.@..@@.@@@.....@@
@.@@@@.@..@.@@...@..@..@@
@......@.@......@@..@.@.@
@.@......@..@.@@@.@.@@.@@
@@......@@@@@@@@@@..@.@@@
@@..@.@@@..@@@@....@....@
@@@@@@@@@@@@@@@@@@@@@@@@@
