50 50
@@@@@@@@@@@@@@@@@@@@@@@@@@@@@@@@@@@@@@@@@@@@@@@@@@
@.........@...@.@..@..@@@..........@..@..@...@..@@
@.@.@.@@.@.@@.@..@..@..@..@.@.@.@@@.@...@@@@.@.@.@
@@...@.@@.......@.@...@@.@@..@@@......@.@..@.....@
@..@......@.@.@.....@......@.@@..@.@@@@@..@..@.@.@
@.@..@.@@@@@..@.@.@.@.@.@@@.@..@.@....@@.@..@@@@.@
@.@@.@@@..@..@..@@.@.@.@..@..@....@@.@.....@@@..@@
@..@.....@..@.@..........@.@.@.@@@..@@@.@@..@..@.@
@@..@.@.@.@@@...@.@.@.@@...........@.@.@.@.@..@..@
@@.@..@......@.@..@.@..@.@.@.@@.@.@..@.@.....@.@.@
@..@@.@.@@@.@...@.@@.@@...@....@.@.@.....@.@@....@
@@...@.....@@@@..@....@.@.@.@.@..@...@.@.@@...@.@@
@.@.@.@.@@.@@.@.@@.@@..@...@....@..@@.@@....@.@..@
@.@....@......@.....@@@.@.@@@@.@@.@.....@@.@.@@.@@
@...@@@..@.@.@..@.@.....@@.@........@@.@.@.....@@@
@.@...@.@...@@@..@@.@@@....@.@.@.@.@@....@.@.@@@@@
@.@@.@@..@.@.@@.@......@.@..@..@.@...@.@@.@.@@@@@@
@@...@..@......@..@.@@.@..@..@@.@..@.@.......@@@@@
@@.@.@.@..@.@.@@.@@..@..@..@.....@.@.@.@.@.@...@@@
@..@@@..@..@....@...@@@..@..@@.@..@@..@.@..@@.@@@@
@@....@@..@.@.@.@.@@.@.@..@...@..@...@@..@...@.@@@
@@.@.@..@...@.@.@......@.@@@.@@.@.@.@...@@.@....@@
@..@.@@..@.@...@@.@.@.@.@.@.@..@..@@.@@...@..@.@@@
@.@@...@..@.@.@...@@.@..@....@.@@.......@@@.@..@@@
@...@.@@.@....@.@.....@..@@.@.....@@.@@....@@@.@@@
@.@..@@....@.@...@.@.@.@......@@@@.@..@.@.@@@@..@@
@.@.@...@.@...@.@@..@..@.@.@@.......@@.@@@.@@@@@@@
@@..@.@@..@@.@.@...@.@.@.@@@.@@.@.@@...@@..@@@@@@@
@.@.@@..@...@....@...........@@@.@...@@...@@@@@@@@
@.....@...@.@.@.@..@.@.@.@.@@.@@...@..@.@@.@.@.@@@
@@@@.@@@@..@@@..@.@...@..@.......@@.@@..........@@
@...@.@...@.@@.@..@.@.@.@..@.@.@.......@.@@@@@@.@@
@.@.@..@@.@...@..@..@..@.@.@..@@@.@.@@@..@....@@@@
@..@.@.....@.@@@.@.@.@....@..@.@..@....@...@.@@.@@
@@.....@.@....@.@..@...@.@@.@...@.@@.@.@.@@......@
@.@.@@..@@.@.@..@@@.@@.@...@.@.@.@.@..@....@@.@.@@
@.@@...@...@..@........@.@@.........@.@.@.@.@..@@@
@..@@.@.@.@..@@@.@.@.@@@....@.@.@@.@.@..@.@...@@@@
@@..@.@....@.@@@@..@@....@.@@@@@..@...@..@@@@.@@@@
@..@.@.@.@..@.@@..@...@.@.@.@.@.@...@.@.@@@@@@@@@@
@@........@.@....@@@.@@.@.........@..@..@@@@@@@@@@
@@@.@.@.@..@..@.@.@.@.....@@.@.@.@..@@@@@@@@@@@@@@
@@..@@..@.@..@@@......@@.@.@.@..@@@.@@@@@@@@@@@@@@
@@@..@.@...@.@@..@.@@.@..@.@.@.@.@.@@@@@@@@@@@@@@@
@@@.@..@.@@.@..@@.@....@....@.......@@@@@@@@@@@@@@
@@@@@@.@.@...@......@.@..@.@@@.@.@@..@@@@@@@@@@@@@
@@@@@@.@@@.@...@.@.@.@..@.@@@..@..@.@@@@@@@@@@@@@@
@@@@@@@@@@.@@.@@@@.@..@...@@..@@@..@@@@@@@@@@@@@@@
@@@@@@@@@@.@@@.....@@...@...@...@@@@@@@@@@@@@@@@@@
@@@@@@@@@@@@@@@@@@@@@@@@@@@@@@@@@@@@@@@@@@@@@@@@@@
