25 25
@@@@@@@@@@@@@@@@@@@@@@@@@
@...@........@.........@@
@.@...@.@@@@@.@.@@.@.@@.@
@.@@.@............@.....@
@...@.@@@@@@.@.@@.@@@.@.@
@@.@@.......@@.@.....@..@
@.....@.@@.@..@..@.@..@.@
@@.@.@...@...@@.@...@@.@@
@...@@.@@..@...@..@..@..@
@@.@..@@..@..@.@.@@@...@@
@....@..@.@.@@@...@..@..@
@@.@@.@.@@@@.@.@.@@.@@@.@
@.........@@...@@..@.@..@
@.@@.@.@@....@@.@.@@..@.@
@@....@.@@.@.........@@@@
@@@.@.....@@@.@.@.@.@.@@@
@@..@.@@.@.@.@..@@.@...@@
@.@..@........@.....@.@@@
@...@.@.@.@@.@..@.@.....@
@@.@@...@..@..@@.@.@.@@@@
@@.@.@@@..@@@......@....@
@.......@..@@@.@@@.@.@@@@
@.@.@@.@..@.@.....@..@@@@
@@...@..@....@.@@..@.@@@@
@@@@@@@@@@@@@@@@@@@@@@@@@
