20 20
@@@@@@@@@@@@@@@@@@@@
@..@@..@@@@........@
@..@.....@@@@@..@@@@
@@.@@@@..@@.@...@.@@
@..@....@.@.@....@.@
@.@.@.@....@.@.@..@@
@.@..@..@..@.@.....@
@...@@@....@@....@.@
@......@@@.....@@@.@
@.@@.@.....@@@@...@@
@.....@..@@...@.@@.@
@...@.@.@.@@.@....@@
@.....@@..@@@..@@.@@
@...@......@.@@@..@@
@.@........@@@...@@@
@...@@.@....@@....@@
@@...@.@......@@@.@@
@@@@..@@....@@@.@..@
@.@.@...@.@@......@@
@@@@@@@@@@@@@@@@@@@@
