26 26
@@@@@@@@@@@@@@@@@@@@@@@@@@
@.@........@...@..@.@..@.@
@..@.@.@..@......@....@..@
@@..@...@..@.@.@.@.@....@@
@....@.@....@.........@..@
@..@...@.@......@@..@@..@@
@@...@.....@@@........@.@@
@.@.@.@...@...@.@.@@.....@
@.@.@..@.@..@@.@.@.....@.@
@....@.@.@.@...........@.@
@.@@...@...@.@.@.@.@@@...@
@@...@.......@@..@.......@
@..@..@..@.@..@@.@...@...@
@@.@......@........@.@.@.@
@.......@........@......@@
@@.@@@.@@@.......@...@.@.@
@..@....@...@.@...@@@@@@.@
@@...@.@@.....@@.@.@.....@
@@.@@....@....@........@.@
@.......@..@....@@...@...@
@..@.@..@@.@..@@.@..@....@
@..@..@..................@
@...@.@...@..@..@.@@...@.@
@..@@..@.@..@...@..@@@@..@
@@...@..@@@..@.@@@.......@
@@@@@@@@@@@@@@@@@@@@@@@@@@
