20 20
@@@@@@@@@@@@@@@@@@@@
@@@@@@@@@@@@@@@@@@@@
@@............@@..@@
@@............@@..@@
@@..@@......@@....@@
@@..@@......@@....@@
@@................@@
@@................@@
@@............@@..@@
@@............@@..@@
@@......@@@@@@@@..@@
@@......@@@@@@@@..@@
@@......@@........@@
@@......@@........@@
@@......@@........@@
@@......@@........@@
@@....@@@@......@@@@
@@....@@@@......@@@@
@@@@@@@@@@@@@@@@@@@@
@@@@@@@@@@@@@@@@@@@@
