22 22
@@@@@@@@@@@@@@@@@@@@@@
@@@@@@@@@@@@@@@@@@@@@@
@@@@@@@@@@@@@@@@@@@@@@
@@@..........@@....@@@
@@@..........@@....@@@
@@@............@@..@@@
@@@............@@..@@@
@@@......@@........@@@
@@@......@@........@@@
@@@....@@@@........@@@
@@@....@@@@........@@@
@@@......@@....@@..@@@
@@@......@@....@@..@@@
@@@@@........@@....@@@
@@@@@........@@....@@@
@@@..@@@@..........@@@
@@@..@@@@..........@@@
@@@..@@........@@..@@@
@@@..@@........@@..@@@
@@@@@@@@@@@@@@@@@@@@@@
@@@@@@@@@@@@@@@@@@@@@@
@@@@@@@@@@@@@@@@@@@@@@
