26 26
@@@@@@@@@@@@@@@@@@@@@@@@@@
@..........@@@@......@@..@
@..........@@@@......@@..@
@@@......@@........@@..@@@
@@@......@@........@@..@@@
@....@@....@@..@@........@
@....@@....@@..@@........@
@@@................@@..@@@
@@@................@@..@@@
@......@@..@@@@..@@......@
@......@@..@@@@..@@......@
@....@@......@@..........@
@....@@......@@..........@
@....@@..@@....@@....@@..@
@....@@..@@....@@....@@..@
@........@@............@@@
@........@@............@@@
@....@@....@@..@@..@@..@@@
@....@@....@@..@@..@@..@@@
@@@....@@..@@........@@..@
@@@....@@..@@........@@..@
@....@@@@..@@..@@..@@....@
@....@@@@..@@..@@..@@....@
@@@..........@@........@@@
@@@..........@@........@@@
@@@@@@@@@@@@@@@@@@@@@@@@@@
