18 18
....@@@@..@@....@@
....@@@@..@@....@@
......@@........@@
......@@........@@
@@......@@..@@@@@@
@@......@@..@@@@@@
@@....@@....@@..@@
@@....@@....@@..@@
........@@@@@@..@@
........@@@@@@..@@
@@@@@@@@@@@@@@@@..
@@@@@@@@@@@@@@@@..
............@@..@@
............@@..@@
@@..@@..@@........
@@..@@..@@........
@@....@@@@@@@@@@@@
@@....@@@@@@@@@@@@
