26 26
@@@@@@@@@@@@@@@@@@@@@@@@@@
@@@..@@@@..@@........@@@@@
@@@..@@@@..@@........@@@@@
@..................@@....@
@..................@@....@
@..@@..@@..@@@@..@@......@
@..@@..@@..@@@@..@@......@
@@@......@@@@..@@..@@..@@@
@@@......@@@@..@@..@@..@@@
@....@@..................@
@....@@..................@
@........@@@@..@@......@@@
@........@@@@..@@......@@@
@@@..@@....@@....@@......@
@@@..@@....@@....@@......@
@....@@..@@..........@@..@
@....@@..@@..........@@..@
@@@....@@........@@..@@..@
@@@....@@........@@..@@..@
@........@@....@@........@
@........@@....@@........@
@....@@..@@....@@@@..@@..@
@....@@..@@....@@@@..@@..@
@......................@@@
@......................@@@
@@@@@@@@@@@@@@@@@@@@@@@@@@
